#Catalan multiwords file used for chunking
a dies	LOC_ADV
A dies	LOC_ADV
A l capdavall	LOC_ADV
a l capdavall	LOC_ADV
a l capdavant	LOC_ADV
A l capdavant	LOC_ADV
A l final	LOC_ADV
a l final	LOC_ADV
a l menys	LOC_ADV
A l menys	LOC_ADV
A l meu torn	LOC_ADV
a l meu torn	LOC_ADV
a l seu torn	LOC_ADV
A l seu torn	LOC_ADV
A l seu voltant	LOC_ADV
a l seu voltant	LOC_ADV
A l teu torn	LOC_ADV
a l teu torn	LOC_ADV
a l' instant	LOC_ADV
A l' instant	LOC_ADV
A la fi	LOC_ADV
a la fi	LOC_ADV
a la vegada	LOC_ADV
A la vegada	LOC_ADV
A les envistes de	LOC_PREP
a les envistes de	LOC_PREP
A les envistes d'	LOC_PREP
a les envistes d'	LOC_PREP
A mesura que	LOC_CONJ
a mesura que	LOC_CONJ
A més	LOC_ADV
a més	LOC_ADV
a més a més	LOC_ADV
A més a més	LOC_ADV
A part	LOC_ADV
a part	LOC_ADV
a penes	LOC_ADV
A penes	LOC_ADV
a poc a poc	LOC_ADV
A poc a poc	LOC_ADV
A recules	LOC_ADV
a recules	LOC_ADV
A reculons	LOC_ADV
a reculons	LOC_ADV
a tota hora	LOC_ADV
A tota hora	LOC_ADV
A trossos	LOC_ADV
a trossos	LOC_ADV
A ulls clucs	LOC_ADV
a ulls clucs	LOC_ADV
A vegades	LOC_ADV
a vegades	LOC_ADV
a vessar	LOC_ADV
A vessar	LOC_ADV
a voltes	LOC_ADV
A voltes	LOC_ADV
a voluntat	LOC_ADV
A voluntat	LOC_ADV
a última hora	LOC_ADV
A última hora	LOC_ADV
així mateix	LOC_CONJ
Així mateix	LOC_CONJ
Això no obstant	LOC_ADV
això no obstant	LOC_ADV
Al capdavall	LOC_ADV
al capdavall	LOC_ADV
al capdavant	LOC_ADV
Al capdavant	LOC_ADV
al final	LOC_ADV
Al final	LOC_ADV
al menys	LOC_ADV
Al menys	LOC_ADV
Al més	LOC_ADV
al més	LOC_ADV
Amb freqüència	LOC_ADV
amb freqüència	LOC_ADV
ara com ara	LOC_ADV
Ara com ara	LOC_ADV
Ara mateix	LOC_ADV
ara mateix	LOC_ADV
Ara per ara	LOC_ADV
ara per ara	LOC_ADV
atenent que	LOC_CONJ
Atenent que	LOC_CONJ
Atès que	LOC_CONJ
atès que	LOC_CONJ
avui dia	LOC_ADV
Avui dia	LOC_ADV
Avui en dia	LOC_ADV
avui en dia	LOC_ADV
bel canto	NCMS000
Bel canto	NCMS000
ben bé	LOC_ADV
Ben bé	LOC_ADV
bona cosa	LOC_ADV
Bona cosa	LOC_ADV
Bé prou	LOC_ADV
bé prou	LOC_ADV
Cada cop menys	LOC_ADV
cada cop menys	LOC_ADV
Cada cop més	LOC_ADV
cada cop més	LOC_ADV
Cada vegada menys	LOC_ADV
cada vegada menys	LOC_ADV
cada vegada més	LOC_ADV
Cada vegada més	LOC_ADV
Cada volta menys	LOC_ADV
cada volta menys	LOC_ADV
Cada volta més	LOC_ADV
cada volta més	LOC_ADV
camp a través	LOC_ADV
Camp a través	LOC_ADV
Cara a cara	LOC_ADV
cara a cara	LOC_ADV
com a	LOC_PREP
Com a	LOC_PREP
Com ara	LOC_CONJ
com ara	LOC_CONJ
cos a cos	LOC_ADV
Cos a cos	LOC_ADV
cos per cos	LOC_ADV
Cos per cos	LOC_ADV
d' alguna manera	LOC_ADV
D' alguna manera	LOC_ADV
D' allò més	LOC_ADV
d' allò més	LOC_ADV
D' altra banda	LOC_CONJ
de iure	LOC_ADV
De iure	LOC_ADV
De manera que	LOC_CONJ
de manera que	LOC_CONJ
De tal manera que	LOC_CONJ
de tal manera que	LOC_CONJ
d' altra banda	LOC_CONJ
d' amagat	LOC_ADV
D' amagat	LOC_ADV
d' antuvi	LOC_ADV
D' antuvi	LOC_ADV
D' esma	LOC_ADV
d' esma	LOC_ADV
d' esquerres	LOC_ADV
D' esquerres	LOC_ADV
D' esquitllada	LOC_ADV
d' esquitllada	LOC_ADV
D' esquitllentes	LOC_ADV
d' esquitllentes	LOC_ADV
D' estar per casa	LOC_ADV
d' estar per casa	LOC_ADV
D' estira i arronsa	LOC_ADV
d' estira i arronsa	LOC_ADV
D' estranquis	LOC_ADV
d' estranquis	LOC_ADV
D' estrena	LOC_ADV
d' estrena	LOC_ADV
d' etiqueta	LOC_ADV
D' etiqueta	LOC_ADV
D' hora	LOC_ADV
d' hora	LOC_ADV
D' imitació	LOC_ADV
d' imitació	LOC_ADV
d' improvís	LOC_ADV
D' improvís	LOC_ADV
D' inicògnit	LOC_ADV
d' inicògnit	LOC_ADV
d' un a un	LOC_ADV
D' un a un	LOC_ADV
d' un cap a l' altre	LOC_ADV
D' un cap a l' altre	LOC_ADV
d' un costat a l' altre	LOC_ADV
D' un costat a l' altre	LOC_ADV
D' un dia a l' altre	LOC_ADV
d' un dia a l' altre	LOC_ADV
D' un plegat	LOC_ADV
d' un plegat	LOC_ADV
d' una vegada	LOC_ADV
D' una vegada	LOC_ADV
D' upa	LOC_ADV
d' upa	LOC_ADV
d' última hora	LOC_ADV
D' última hora	LOC_ADV
da capo	LOC_ADV
Da capo	LOC_ADV
damunt dit	LOC_ADV
Damunt dit	LOC_ADV
de bell antuvi	LOC_ADV
De bell antuvi	LOC_ADV
De bell nou	LOC_ADV
de bell nou	LOC_ADV
De bell principi	LOC_ADV
de bell principi	LOC_ADV
De biaix	LOC_ADV
de biaix	LOC_ADV
De bocaterrosa	LOC_ADV
de bocaterrosa	LOC_ADV
De bona font	LOC_ADV
de bona font	LOC_ADV
de bona gana	LOC_ADV
De bona gana	LOC_ADV
de debò	LOC_ADV
De debò	LOC_ADV
de dretes	LOC_ADV
De dretes	LOC_ADV
de gom a gom	LOC_ADV
De gom a gom	LOC_ADV
De l tot	LOC_ADV
de l tot	LOC_ADV
De més a més	LOC_ADV
de més a més	LOC_ADV
De nou	LOC_ADV
de nou	LOC_ADV
de pressa	LOC_ADV
De pressa	LOC_ADV
de seguida	LOC_ADV
De seguida	LOC_ADV
De segur	LOC_ADV
de segur	LOC_ADV
de sobte	LOC_ADV
De sobte	LOC_ADV
de soca-rel	LOC_ADV
De soca-rel	LOC_ADV
de sol a sol	LOC_ADV
De sol a sol	LOC_ADV
De sorpresa	LOC_ADV
de sorpresa	LOC_ADV
De sotamà	LOC_ADV
de sotamà	LOC_ADV
De tal manera	LOC_ADV
de tal manera	LOC_ADV
De tant en tant	LOC_ADV
de tant en tant	LOC_ADV
de tard en tard	LOC_ADV
De tard en tard	LOC_ADV
de tomballons	LOC_ADV
De tomballons	LOC_ADV
De tort	LOC_ADV
de tort	LOC_ADV
de tot cor	LOC_ADV
De tot cor	LOC_ADV
De tot en tota	LOC_ADV
de tot en tota	LOC_ADV
de través	LOC_ADV
De través	LOC_ADV
de vegades	LOC_ADV
De vegades	LOC_ADV
De veres	LOC_ADV
de veres	LOC_ADV
De veritat	LOC_ADV
de veritat	LOC_ADV
de via estreta	LOC_ADV
De via estreta	LOC_ADV
de viu en viu	LOC_ADV
De viu en viu	LOC_ADV
De viva veu	LOC_ADV
de viva veu	LOC_ADV
Del tot	LOC_ADV
del tot	LOC_ADV
Dia i nit	LOC_ADV
dia i nit	LOC_ADV
dia sí dia no	LOC_ADV
Dia sí dia no	LOC_ADV
donat que	LOC_CONJ
Donat que	LOC_CONJ
En absolut	LOC_ADV
en absolut	LOC_ADV
en acabat	LOC_ADV
En acabat	LOC_ADV
en actiu	LOC_ADV
En actiu	LOC_ADV
En alt grau	LOC_ADV
en alt grau	LOC_ADV
en altre temps	LOC_ADV
En altre temps	LOC_ADV
en amunt	LOC_ADV
En amunt	LOC_ADV
En avall	LOC_ADV
en avall	LOC_ADV
En blanc	LOC_ADV
en blanc	LOC_ADV
En bona fe	LOC_ADV
en bona fe	LOC_ADV
en bona hora	LOC_ADV
En bona hora	LOC_ADV
En bona part	LOC_ADV
en bona part	LOC_ADV
en breu	LOC_ADV
En breu	LOC_ADV
en brut	LOC_ADV
En brut	LOC_ADV
En cadena	LOC_ADV
en cadena	LOC_ADV
en certa manera	LOC_ADV
En certa manera	LOC_ADV
En comú	LOC_ADV
en comú	LOC_ADV
En conill	LOC_ADV
en conill	LOC_ADV
En creu	LOC_ADV
en creu	LOC_ADV
En dejú	LOC_ADV
en dejú	LOC_ADV
En detall	LOC_ADV
en detall	LOC_ADV
en doina	LOC_ADV
En doina	LOC_ADV
en efecte	LOC_ADV
En efecte	LOC_ADV
en efectiu	LOC_ADV
En efectiu	LOC_ADV
en especial	LOC_ADV
En especial	LOC_ADV
En fals	LOC_ADV
en fals	LOC_ADV
en ferm	LOC_ADV
En ferm	LOC_ADV
En fi	LOC_ADV
en fi	LOC_ADV
En fresc	LOC_ADV
en fresc	LOC_ADV
En general	LOC_ADV
en general	LOC_ADV
En gran part	LOC_ADV
en gran part	LOC_ADV
En la mesura que	LOC_CONJ
en la mesura que	LOC_CONJ
En la seua majoria	LOC_ADV
en la seua majoria	LOC_ADV
en la seva majoria	LOC_ADV
En la seva majoria	LOC_ADV
en part	LOC_ADV
En part	LOC_ADV
en particular	LOC_ADV
En particular	LOC_ADV
en realitat	LOC_ADV
En realitat	LOC_ADV
En secret	LOC_ADV
en secret	LOC_ADV
en temps en temps	LOC_ADV
En temps en temps	LOC_ADV
enfront d' 	LOC_ADV
Enfront d' 	LOC_ADV
Enfront de	LOC_ADV
enfront de	LOC_ADV
Enfront del	LOC_ADV
enfront del	LOC_ADV
enfront dels	LOC_ADV
Enfront dels	LOC_ADV
Estats Units	NPMPG00
fa poc	LOC_ADV
Fa poc	LOC_ADV
Fet i fet	LOC_ADV
fet i fet	LOC_ADV
Fins ara	LOC_ADV
fins ara	LOC_ADV
Fins avui	LOC_ADV
fins avui	LOC_ADV
fins i tot	LOC_ADV
Fins i tot	LOC_ADV
front a front	LOC_ADV
Front a front	LOC_ADV
futbol sala	NCMS000
Futbol sala	NCMS000
Gens ni mica	LOC_ADV
gens ni mica	LOC_ADV
Gran Bretanya	NPFSG00
gràcies a	LOC_PREP
Gràcies a	LOC_PREP
haguts i per haver	LOC_ADJ
honoris causa	LOC_ADV
Honoris causa	LOC_ADV
Junt amb	LOC_PREP
junt amb	LOC_PREP
juntament amb	LOC_PREP
Juntament amb	LOC_PREP
Més i més	LOC_ADV
més i més	LOC_ADV
més o menys	LOC_ADV
Més o menys	LOC_ADV
mutatis mutandis	LOC_ADV
Mutatis mutandis	LOC_ADV
no fa gaire	LOC_ADV
No fa gaire	LOC_ADV
no gaire	LOC_ADV
No gaire	LOC_ADV
No gens	LOC_ADV
no gens	LOC_ADV
No obstant això	LOC_ADV
no obstant això	LOC_ADV
oi més	LOC_ADV
Oi més	LOC_ADV
Pe l cap alt	LOC_ADV
pe l cap alt	LOC_ADV
pe l cap baix	LOC_ADV
Pe l cap baix	LOC_ADV
pel cap alt	LOC_ADV
Pel cap alt	LOC_ADV
Pel cap baix	LOC_ADV
pel cap baix	LOC_ADV
per damunt de tot	LOC_ADV
Per damunt de tot	LOC_ADV
per exemple	LOC_ADV
Per exemple	LOC_ADV
per mor de	LOC_PREP
Per mor de	LOC_PREP
per mor d'	LOC_PREP
Per mor d'	LOC_PREP
per se	LOC_ADV
Per se	LOC_ADV
per sobre de tot	LOC_ADV
Per sobre de tot	LOC_ADV
qui-sap-lo	LOC_ADV
Qui-sap-lo	LOC_ADV
segons que	LOC_CONJ
Segons que	LOC_CONJ
Seguit seguit	LOC_ADV
seguit seguit	LOC_ADV
Si fa no fa	LOC_ADV
si fa no fa	LOC_ADV
Si més no	LOC_ADV
si més no	LOC_ADV
tan solament	LOC_ADV
Tan solament	LOC_ADV
tan sols	LOC_ADV
Tan sols	LOC_ADV
Tant menys	LOC_ADV
tant menys	LOC_ADV
Tant més	LOC_ADV
tant més	LOC_ADV
Tot d' una	LOC_ADV
tot d' una	LOC_ADV
tot just	LOC_ADV
Tot just	LOC_ADV
tot seguit	LOC_ADV
Tot seguit	LOC_ADV
Tot sol	LOC_ADV
tot sol	LOC_ADV
Tota sola	LOC_ADV
tota sola	LOC_ADV
Totes soles	LOC_ADV
totes soles	LOC_ADV
Tots sols	LOC_ADV
tots sols	LOC_ADV
tour de force	NCMS000
Tour de force	NCMS000
ultra mesura	LOC_ADV
Ultra mesura	LOC_ADV
un poc	LOC_ADV
Un poc	LOC_ADV
un xic	LOC_ADV
Un xic	LOC_ADV
una mica	LOC_ADV
Una mica	LOC_ADV
vist i no vist	LOC_ADV
Vist i no vist	LOC_ADV
